Слова по английскому.
- в скобках вариации одного и того же слова
- найдете ошибки, пишите в issuses
- в квадратных скобках произношение
- в фигурных скобках этимология слова
- большими буквами в транскрипции проставленны ударения
- звездой обозначаются возможные неправильные строки (в релизе не должно быть звезд)

active attack - активная атака
active cyberdefence - активная кибероборона
antivirus - антивирус
antivirus app - приложение антивируса
antivirus personnel - персонал службы поддержки антивирусов
antivirus policy - антивирусная политика
antivirus protection - антивирусная защита
bacterium - бактерия, микроб, тип компьютерного вируса
bankcard fraud - мошенничество с банковскими картами
banker trojan - банковский троян
behaviour - поведение, в ИБ действия и операции, которые выполняет вредоносная программа в зараженной системе
behavioural anomaly detection - технологии обнаружения зловредного ПО
behaviour blocker - поведенческий блокиратор
benign environment - благоприятная среда
biometric data - биометрические данные
biometric identification - биометрическая идентификация
black hat hacker - зловредный (черный) хакер
blacklist - черный список
blacklisting - технология "черных списков"
blackmail - шантаж
botnet - сеть зомбированных компьютеров
bug bounty - премия за обнаружения уязвимости
cyber attack - кибератака
cyber attacker - кибервзломщик
cyber conflict - киберконфликт
cybercrime - киберпреступность, киберпреступления
cybercriminal - киберпреступник
cyberdefense - кибероборона
cyber incident - киберинцидент
cyberlaw - киберправо
cyber operation - кибероперация
cyder protection - киберзащита
cyder resilience - устойчивасть к киберугрозам
cyber risk - киберугроза, кибер риск
cybersecurity - безопасность в киберпространстве
cyder secutrity expert - эксперт по кибербезопасности
cybersecurity adviser - советник по кибербезопасности
cybersecurity analyst - аналитик по кибербезопасности
cybersecurity application - приложение для кибербезопасности
cybersecurity business - бизнес в области кибербезопасности
cybersecurity certificate - сертификат специалиста по кибербезопасности
cybersecurity employer - работадатель для специалиста по кибербезопасности
cybersecurity hardening - повышение уровня ИБ
cybersecurity hardening guide - руководство по повышению кибербезопасности
cybersecurity incident - нарушение кибербезопасности
cybersecurity market - рынок средств кибербезопасности
cybersecurity report - сообщение о нарушении кибербезопасности
cybersecurity researcher - исследователь в области кибербезопасности
cybersecurity solution - решение в области кибербезопасности
cybersecurity spending - расходы на кибербезопасность
cybersecurity strategy - стратегия обеспечения кибербезопасности
cybersecurity technology - технология кибербезопасности
data breach - несанкционированный доступ к данным
data leakage - утечка данных
data privacy - конфиденциальность (приватность) данных
data security - защита (защищенность, безопасность) данных
defence in depth - многоуровневая защита
destruction - уничтожение, разрушение
disclose information - разглашать информацию
disclosure - демаскирование, раскрытие, разглашение
demilitarized zone (DMZ) - демилитаризованная зона
downgrade (downgrading) - понижение уровня, так же понижение в звании, статусе, оценки
Data Protection as a Service (DPaaS) - защита данных как услуга, сервис, модель обеспечения сохранности данных
eavesdropping - перехват, прослушка, прослушивание
eavesdropping attack - атака прослушиванием
encrypted software - ПО с криптографической защитой
enterprise security - корпоративная безопасность
entrapment - подставка, ловушка
evidence - доказательство, вещественное доказательство, также служить доказательством, доказать
exculpatory evidence - доказательство невиновности
external security testing - внешнее тестирование средств обеспечения средств безопасности
false negative (FN) - ошибочный отказ, ложно отрицательная (аутентификация)
false positive (FP) - ошибочный допуск, ложно положительная (аутентификация)
file protection - защита файла
file sandboxing - проверка файла в песочнице 
file security - безопасность файлов
Forum for Incident and Response Security Team (FIRST) - форум команд по ИБ и реакциям на инциденты ИБ
foothold expansion - упрощение позиции атакующего (расширение плацдарма)
fraud - обман, мошенничество
guard code - защитный код 
hacker attack - хакерская атака
hacker group - хакерская группа
hacker-powered security - обеспечение ИБ белыми хакерами
hacking threat - хакерская угроза
hacking - взлом, неавторизованный доступ
hacking community - сообщество хакеров
hacking spike - всплеск хакерской активности
hacking techniques - методы хакинга (техники)
hacking tool - инструмент для хакинга
hardware security - аппаратная защита, защита "по железу". Защита обеспеченная какими-либо физическими инструментами
hardware vulnerability - аппаратная уязвимость, уязвимость аппаратного обеспечения
hardware weakness - аппаратная уязвимость (сисноним прошлого), "слабость" аппаратуры
high impact (HI HIM HIMP) - сильзое воздействие, сильный эффект, высокая уязвимость, большой ущерб
high-impact system - система высокой уязвимости
high-tech crime - высокотехнологическое преступление
honeynet - сеть-приманка, сеть-ловушка
honeypot - хост-приманка, сеть-ловушка
human factor (HE) - человеческий фактор , самое слобае звено в ИТ и ИБ
hybrid security control - гибридный контроль безопасности
identity, credential, and access management (ICAM) - системиа идентификации, электронных удоставерений и контроля доступа
identity theft - хищение личных данных, кража личности
impact - воздействие, влияние
impact value - величина потенциального или реального ущерба
impersonation - маскирофка нарушителя, маскровка вредоносного ПО под не вредоносное
inadvertent disclosure - непреднамеренное раскрытие информации
incident - инцедент, проеществие
incident diary - дневник, журнал учета проеществий (инцедентов)
incident handling - обработка проеществий
incident management - контроль проеществий
incident outsourcing - аутсорсинг инцедентов 
incident prevention - предупреждение инцедентов
incident reporting - отчет по инцедентов
incident response - реакция на инцедент 
incident response plan - план реагирования на инцеденты
incident scope - масштаб инцедента
incident solving - решение инцедента